1111111111111111111111111111111111111111111111
11000000000000000M0000000000000000000000000001
1100111111111111111111111111000000000000000001
1000000000000000000000100000000000011100000001
100000M0000000000M0000E0000000000000000M000001
1000000000010010000000000000000000000000000001
10000000001C00P0000000100000000000000000000001
1000000000010010000000010001111000000000000001
10000000000000000000000C00100000M00M0000000001
1000000000011111110000010000000011110000000001
1000000000000000000000000000000000000000000001
1000000000000000000000000000000000000000000001
1000000000000000000000000000000111111100000011
1111111111111111111111111111111111111111111111