1111111111111111111
100100000001CE00001
1000011111010100001
1000011111000000001
1P00110000000000001
1111111111111111111