1111111111
1100100000
1100001111
1100001111
1100001111
1100001111
1100001111
1100001111
11P0011000
1111111111