1111111111
110010000E
1100001111
1100001111
1100001111
1100001111
1100001111
1100001111
11P0011001
1111111111